15
15
===============
=      $      =
= K        M  =
=             =
=====*****=====
=         #   =
=!!      F#   =
=T!       #X  =
=!!        ====
=  $          =
======   ^    =
=   @=        =
=    =        =
=X   =   W    =
===============
1
7 11 13 1
50