15
20
====================
=        =K        =
=   !!!  =     W   =
= $ !M!  * ^X  =====
=   !!!  *    *    =
=        *    *    =
=   X    *    * X  =
====================
=  $     =         =
=   ^    #!        =
=        #!     T  =
=  @     #!        =
=  ^     #!  $     =
=        =    X    =
====================
2
6 4 3 12
6 16 13 14
90