13
20
====================
=    !M!  =$  W K  =
=    !!!  =X       =
=X        *    ****=
=      ^  *    *X $=
=         *    *   =
====================
=     $   #        =
=^        !   $    =
=         =        =
=  @      = X    T =
=         =        =
====================
2
3 1 2 11
4 16 10 12
90