15
20
====================
=       =          =
= !  M  *   W    @ =
=       *          =
=    !  *          =
= $     =          =
====##===      ^   =
=       =    T     =
=    ^  ============
=                  =
=   *****       K  =
=   *$*$*          =
=   *****          =
=                  =
====================
0
90