10
10
==========
=  K  #$ =
=     M  =
=  * $  !=
= W   $  =
=   @  X =
=      F =
=  X     =
=$ ^  T  =
==========
1
5 7 7 3
30