22
16
================
=    $         =
= X    ! K *** =
=      !   *@* =
=$         *** =
=              =
===##===========
=              =
= X   T     !! =
=              =
=      ^       =
=         ^ X  =
= $            =
=      $       =
===========##===
=              =
=              =
=  M           =
=       W   X  =
= $            =
=              =
================
2
18 12 8 2
11 12 2 2
-1