11
10
==========
=K      M=
====**====
=  $  *  =
=T    #X =
=!     ===
=        =
====   ^ =
= @=     =
=X =    W=
==========
1
4 7 9 1
50