13
9
=========
= $     =
=  K  # =
=       =      
=  $ M  =
=  *   !=
= W     =
=   @ X =
=     F =
=   $   =
=  X    =
=  ^ T  =
=========
1
7 6 10 3