13
9
=========
= B     =
=  K  # =
=       =      
=    M  =
=  *   !=
= W     =
=   @ X =
=     F =
=       =
=  X    =
=B ^ T  =
=========
1
7 6 10 3