10
12
============
=  !  #    =
=          =
=  * B  !  =
= W        =
=  ^@      =
=          =
=  B   K   =
=B    T    =
============
0