10
20
====================
=  !  #            =
=                  =
=  * B  !          =
= W                =
=  ^@              =
=       M          =
=  $           K   =
=        $    T    =
====================
0
40